28x36
1 1 1 1 1 1 1 1 1 1 1 1 1 1 1 1 1 1 1 1 1 1 1 1 1 1 1 1
1 1 1 1 1 1 1 1 1 1 1 1 1 1 1 1 1 1 1 1 1 1 1 1 1 1 1 1
1 1 1 1 1 1 1 1 1 1 1 1 1 1 1 1 1 1 1 1 1 1 1 1 1 1 1 1
1 1 1 1 1 1 1 1 1 1 1 1 1 1 1 1 1 1 1 1 1 1 1 1 1 1 1 1
1 3 0 0 0 0 9 0 0 0 0 0 4 1 1 3 0 0 0 0 0 9 0 0 0 0 4 1
1 7 1 1 1 1 7 1 1 1 1 1 7 1 1 0 1 1 1 1 1 7 1 1 1 1 0 1
1 7 1 1 1 1 7 1 1 1 1 1 7 1 1 0 1 1 1 1 1 7 1 1 1 1 0 1
1 7 1 1 1 1 7 1 1 1 1 1 7 1 1 0 1 1 1 1 1 7 1 1 1 1 0 1
1 b 0 0 0 0 c 0 0 9 0 0 8 0 0 8 0 0 9 0 0 c 0 0 0 0 a 1
1 7 1 1 1 1 7 1 1 0 1 1 1 1 1 1 1 1 0 1 1 7 1 1 1 1 0 1
1 7 1 1 1 1 7 1 1 0 1 1 1 1 1 1 1 1 0 1 1 7 1 1 1 1 0 1
1 5 0 0 0 0 b 1 1 5 0 0 4 1 1 3 0 0 6 1 1 a 0 0 0 0 6 1
1 1 1 1 1 1 7 1 1 1 1 1 7 1 1 7 1 1 1 1 1 7 1 1 1 1 1 1
1 1 1 1 1 1 7 1 1 1 1 1 7 1 1 7 1 1 1 1 1 7 1 1 1 1 1 1
1 1 1 1 1 1 7 1 1 3 0 0 8 pd 0 c 0 0 4 1 1 7 1 1 1 1 1 1
1 1 1 1 1 1 7 1 1 7 1 1 1 1 1 0 1 1 7 1 1 7 1 1 1 1 1 1
1 1 1 1 1 1 7 1 1 7 1 1 1 1 1 0 1 1 7 1 1 7 1 1 1 1 1 1
2 0 0 0 0 0 c 0 0 b 1 1 1 1 1 0 1 1 b 0 0 c 0 0 0 0 0 0
1 1 1 1 1 1 7 1 1 7 1 1 1 1 1 0 1 1 7 1 1 7 1 1 1 1 1 1
1 1 1 1 1 1 7 1 1 0 1 1 1 1 1 0 1 1 7 1 1 7 1 1 1 1 1 1
1 1 1 1 1 1 7 1 1 a 0 0 0 p 0 b 0 0 b 1 1 7 1 1 1 1 1 1
1 1 1 1 1 1 7 1 1 7 1 1 1 1 1 1 1 1 0 1 1 7 1 1 1 1 1 1
1 1 1 1 1 1 7 1 1 7 1 1 1 1 1 1 1 1 7 1 1 7 1 1 1 1 1 1
1 3 0 0 0 0 c 0 0 8 0 0 4 1 1 3 0 0 8 0 0 c 0 0 0 0 4 1
1 7 1 1 1 1 7 1 1 1 1 1 7 1 1 7 1 1 1 1 1 7 1 1 1 1 7 1
1 7 1 1 1 1 7 1 1 1 1 1 7 1 1 7 1 1 1 1 1 7 1 1 1 1 7 1
1 5 0 4 1 1 a 0 0 9 0 0 8 0 0 8 0 0 9 0 0 b 1 1 3 0 6 1
1 1 1 7 1 1 7 1 1 7 1 1 1 1 1 1 1 1 7 1 1 7 1 1 7 1 1 1
1 1 1 7 1 1 7 1 1 7 1 1 1 1 1 1 1 1 7 1 1 7 1 1 7 1 1 1
1 3 0 8 0 0 6 1 1 5 0 0 4 1 1 3 0 0 6 1 1 5 0 0 8 0 4 1
1 7 1 1 1 1 1 1 1 1 1 1 7 1 1 7 1 1 1 1 1 1 1 1 1 1 7 1
1 7 1 1 1 1 1 1 1 1 1 1 7 1 1 7 1 1 1 1 1 1 1 1 1 1 7 1
1 5 0 0 0 0 0 0 0 0 0 0 8 0 0 8 0 0 0 0 0 0 0 0 0 0 6 1
1 1 1 1 1 1 1 1 1 1 1 1 1 1 1 1 1 1 1 1 1 1 1 1 1 1 1 1
1 1 1 1 1 1 1 1 1 1 1 1 1 1 1 1 1 1 1 1 1 1 1 1 1 1 1 1
1 1 1 1 1 1 1 1 1 1 1 1 1 1 1 1 1 1 1 1 1 1 1 1 1 1 1 1